account_id,operator_id,player_id,checkin_time,checkout_time,last_visit,init_token,profit,withdraw,player_skill,rounds,wins,loss
1,1,1,2019-08-11 21:19,2019-08-12 01:55,2019-08-11 21:19:25.265649,400,146,546,8.935557625991093,23,14,9
2,1,1,2019-08-18 21:19,2019-08-19 01:55,2019-08-18 21:19:25.265649,310,291,601,8.935566940679116,23,17,6
3,1,1,2019-08-16 21:19,2019-08-17 01:55,2019-08-16 21:19:25.265649,510,99,609,8.935566940679116,23,12,11
4,1,2,2019-08-12 06:41,2019-08-12 10:53,2019-08-12 06:41:25.290962,700,-700,0,6.132291941403362,21,4,17
5,1,2,2019-08-17 06:41,2019-08-17 11:17,2019-08-17 06:41:25.290962,740,-740,0,6.150628124680199,23,4,19
6,1,2,2019-08-16 06:41,2019-08-16 10:17,2019-08-16 06:41:25.290962,860,-860,0,6.144876876725468,18,2,16
7,1,3,2019-08-11 21:21,2019-08-12 02:45,2019-08-11 21:21:25.318984,100,-100,0,6.395372122428246,27,7,20
8,1,3,2019-08-17 21:21,2019-08-18 02:09,2019-08-17 21:21:25.318984,100,-100,0,6.411523713237781,24,5,19
9,1,3,2019-08-18 21:21,2019-08-19 01:57,2019-08-18 21:21:25.318984,80,-80,0,6.410506777592129,23,5,18
10,1,4,2019-08-12 04:21,2019-08-12 10:09,2019-08-12 04:21:25.469591,500,-48,452,7.7822293221672005,29,14,15
11,1,4,2019-08-19 04:21,2019-08-19 08:45,2019-08-19 04:21:25.469591,500,-59,441,7.785328588954618,22,11,11
12,1,4,2019-08-15 04:21,2019-08-15 09:09,2019-08-15 04:21:25.469591,580,211,791,7.785771108998853,24,14,10
13,1,5,2019-08-12 05:44,2019-08-12 10:08,2019-08-12 05:44:25.494895,700,-362,338,6.510555202411867,22,8,14
14,1,5,2019-08-16 05:44,2019-08-16 10:56,2019-08-16 05:44:25.494895,590,-590,0,6.527230002634487,26,6,20
15,1,5,2019-08-15 05:44,2019-08-15 09:56,2019-08-15 05:44:25.494895,720,-383,337,6.522585129747726,21,7,14
16,2,1,2019-08-12 00:12,2019-08-12 05:48,2019-08-12 00:12:25.518994,200,-200,0,7.516821512051971,28,7,21
17,2,1,2019-08-15 00:12,2019-08-15 06:00,2019-08-15 00:12:25.518994,260,-124,136,7.523830887369513,29,11,18
18,2,1,2019-08-15 00:12,2019-08-15 05:36,2019-08-15 00:12:25.518994,220,-214,6,7.523107668559144,27,7,20
19,2,2,2019-08-12 02:55,2019-08-12 08:07,2019-08-12 02:55:25.540828,700,517,1217,8.87913339741264,26,18,8
20,2,2,2019-08-17 02:55,2019-08-17 08:31,2019-08-17 02:55:25.540828,510,219,729,8.879177698018031,28,17,11
21,2,2,2019-08-16 02:55,2019-08-16 07:31,2019-08-16 02:55:25.540828,780,156,936,8.879166160565125,23,13,10
22,2,3,2019-08-12 02:13,2019-08-12 07:25,2019-08-12 02:13:25.565058,1000,270,1270,8.588895956038927,26,14,12
23,2,3,2019-08-15 02:13,2019-08-15 08:37,2019-08-15 02:13:25.565058,840,94,934,8.58952380862276,32,16,16
24,2,3,2019-08-18 02:13,2019-08-18 08:01,2019-08-18 02:13:25.565058,900,-900,0,8.589436241491656,29,8,21
25,2,4,2019-08-12 04:00,2019-08-12 09:36,2019-08-12 04:00:25.589426,200,-115,85,6.725136342689069,28,10,18
26,2,4,2019-08-19 04:00,2019-08-19 09:12,2019-08-19 04:00:25.589426,150,-120,30,6.739068108322558,26,8,18
27,2,4,2019-08-19 04:00,2019-08-19 08:24,2019-08-19 04:00:25.589426,240,-240,0,6.735929051909512,22,4,18
28,2,5,2019-08-12 04:01,2019-08-12 10:13,2019-08-12 04:01:25.613487,900,-306,594,8.463117651761289,31,13,18
29,2,5,2019-08-15 04:01,2019-08-15 09:49,2019-08-15 04:01:25.613487,720,-35,685,8.464038759310295,29,14,15
30,2,5,2019-08-16 04:01,2019-08-16 09:25,2019-08-16 04:01:25.613487,890,57,947,8.463943466314587,27,15,12
31,2,6,2019-08-11 23:32,2019-08-12 04:56,2019-08-11 23:32:25.636784,500,-44,456,8.921153484076761,27,14,13
32,2,6,2019-08-15 23:32,2019-08-16 06:20,2019-08-15 23:32:25.636784,520,677,1197,8.921178846738375,34,26,8
33,2,6,2019-08-14 23:32,2019-08-15 04:20,2019-08-14 23:32:25.636784,500,15,515,8.921168370228655,24,12,12
34,2,7,2019-08-12 06:20,2019-08-12 10:56,2019-08-12 06:20:25.661745,900,-900,0,6.467746189117807,23,5,18
35,2,7,2019-08-16 06:20,2019-08-16 09:44,2019-08-16 06:20:25.661745,820,-820,0,6.476733624664598,17,2,15
36,2,7,2019-08-18 06:20,2019-08-18 10:44,2019-08-18 06:20:25.661745,940,-124,816,6.481112554520955,22,10,12
37,2,8,2019-08-12 04:34,2019-08-12 10:34,2019-08-12 04:34:25.731581,300,-147,153,7.775822969585362,30,12,18
38,2,8,2019-08-17 04:34,2019-08-17 11:10,2019-08-17 04:34:25.731581,260,32,292,7.7816397293586705,33,18,15
39,2,8,2019-08-19 04:34,2019-08-19 09:58,2019-08-19 04:34:25.731581,330,-167,163,7.780108402471185,27,10,17
40,2,9,2019-08-12 06:10,2019-08-12 11:22,2019-08-12 06:10:25.760503,400,-297,103,6.192978999467342,26,8,18
41,2,9,2019-08-15 06:10,2019-08-15 11:22,2019-08-15 06:10:25.760503,510,-456,54,6.214162236687451,26,6,20
42,2,9,2019-08-15 06:10,2019-08-15 09:46,2019-08-15 06:10:25.760503,310,-310,0,6.205037968246194,18,2,16
43,2,10,2019-08-11 23:15,2019-08-12 04:03,2019-08-11 23:15:25.790503,300,-118,182,6.977314334311865,24,10,14
44,2,10,2019-08-18 23:15,2019-08-19 03:39,2019-08-18 23:15:25.790503,240,-62,178,6.985851093344705,22,9,13
45,2,10,2019-08-16 23:15,2019-08-17 02:39,2019-08-16 23:15:25.790503,350,-350,0,6.983052421293627,17,2,15
46,3,1,2019-08-12 01:59,2019-08-12 06:35,2019-08-12 01:59:25.817035,800,-188,612,8.791370894238177,23,10,13
47,3,1,2019-08-16 01:59,2019-08-16 07:11,2019-08-16 01:59:25.817035,1040,468,1508,8.791488698359196,26,16,10
48,3,1,2019-08-19 01:59,2019-08-19 07:59,2019-08-19 01:59:25.817035,850,560,1410,8.791517528760508,30,19,11
49,3,2,2019-08-12 02:24,2019-08-12 08:24,2019-08-12 02:24:25.844548,900,296,1196,8.770425576349119,30,17,13
50,3,2,2019-08-19 02:24,2019-08-19 08:24,2019-08-19 02:24:25.844548,900,-259,641,8.77060311951885,30,14,16
51,3,2,2019-08-15 02:24,2019-08-15 07:36,2019-08-15 02:24:25.844548,980,-421,559,8.770568213996414,26,10,16
52,3,3,2019-08-12 07:07,2019-08-12 11:19,2019-08-12 07:07:25.869643,700,-94,606,8.470616193420664,21,10,11
53,3,3,2019-08-17 07:07,2019-08-17 11:43,2019-08-17 07:07:25.869643,820,31,851,8.4712441601241,23,11,12
54,3,3,2019-08-19 07:07,2019-08-19 14:55,2019-08-19 07:07:25.869643,780,675,1455,8.472022058511309,39,25,14
55,3,4,2019-08-12 02:42,2019-08-12 07:30,2019-08-12 02:42:25.893767,900,202,1102,8.469026809799663,24,13,11
56,3,4,2019-08-17 02:42,2019-08-17 07:30,2019-08-17 02:42:25.893767,660,162,822,8.469701206252463,24,13,11
57,3,4,2019-08-19 02:42,2019-08-19 07:42,2019-08-19 02:42:25.893767,880,350,1230,8.469744772173437,25,15,10
58,3,5,2019-08-12 01:04,2019-08-12 07:28,2019-08-12 01:04:25.917346,900,-17,883,8.74564247462088,32,16,16
59,3,5,2019-08-18 01:04,2019-08-18 05:40,2019-08-18 01:04:25.917346,1080,-341,739,8.745787531646291,23,9,14
60,3,5,2019-08-15 01:04,2019-08-15 06:28,2019-08-15 01:04:25.917346,1040,434,1474,8.74582797728748,27,16,11
61,3,6,2019-08-12 07:03,2019-08-12 12:39,2019-08-12 07:03:25.938341,800,123,923,8.853676035554066,28,15,13
62,3,6,2019-08-17 07:03,2019-08-17 12:03,2019-08-17 07:03:25.938341,670,93,763,8.85373061051129,25,13,12
63,3,6,2019-08-19 07:03,2019-08-19 11:15,2019-08-19 07:03:25.938341,680,-205,475,8.85371777623002,21,8,13
64,3,7,2019-08-12 01:20,2019-08-12 05:32,2019-08-12 01:20:25.961619,1000,-29,971,7.704996914670983,21,10,11
65,3,7,2019-08-16 01:20,2019-08-16 06:08,2019-08-16 01:20:25.961619,920,-920,0,7.709001492520447,24,6,18
66,3,7,2019-08-15 01:20,2019-08-15 06:32,2019-08-15 01:20:25.961619,860,-70,790,7.709523112429316,26,13,13
67,3,8,2019-08-12 02:42,2019-08-12 07:42,2019-08-12 02:42:25.986837,300,20,320,7.477986531649393,25,13,12
68,3,8,2019-08-18 02:42,2019-08-18 07:42,2019-08-18 02:42:25.986837,270,-171,99,7.483871567614686,25,8,17
69,3,8,2019-08-16 02:42,2019-08-16 08:18,2019-08-16 02:42:25.986837,260,-203,57,7.484982823523395,28,8,20
