account_id,operator_id,player_id,checkin_time,checkout_time,last_visit,init_token,profit,withdraw,player_skill,rounds,wins,loss
1,1,1,2019-08-12 06:31,2019-08-12 09:19,2019-08-12 06:31:25.389373,100,31,131,8.446358661695577,14,9,5
2,1,1,2019-08-15 06:31,2019-08-15 09:31,2019-08-15 06:31:25.389373,80,-18,62,8.44671317847416,15,6,9
3,1,1,2019-08-17 06:31,2019-08-17 09:31,2019-08-17 06:31:25.389373,90,-6,84,8.44671317847416,15,7,8
4,1,2,2019-08-12 06:21,2019-08-12 09:21,2019-08-12 06:21:25.418070,900,228,1128,8.029284928361609,15,9,6
5,1,2,2019-08-19 06:21,2019-08-19 09:09,2019-08-19 06:21:25.418070,930,165,1095,8.030263017056988,14,8,6
6,1,2,2019-08-17 06:21,2019-08-17 09:21,2019-08-17 06:21:25.418070,1040,131,1171,8.030374285480589,15,8,7
7,1,3,2019-08-12 03:35,2019-08-12 06:23,2019-08-12 03:35:25.443155,200,8,208,8.841044937684895,14,7,7
8,1,3,2019-08-15 03:35,2019-08-15 05:59,2019-08-15 03:35:25.443155,190,80,270,8.841065537509854,12,9,3
9,1,3,2019-08-17 03:35,2019-08-17 06:11,2019-08-17 03:35:25.443155,150,30,180,8.84106830462211,13,8,5
10,1,4,2019-08-12 02:23,2019-08-12 04:59,2019-08-12 02:23:25.597993,900,-276,624,8.437021248766333,13,4,9
11,1,4,2019-08-18 02:23,2019-08-18 04:47,2019-08-18 02:23:25.597993,890,4,894,8.4372795758669,12,6,6
12,1,4,2019-08-16 02:23,2019-08-16 04:47,2019-08-16 02:23:25.597993,1130,-336,794,8.4372795758669,12,4,8
13,1,5,2019-08-12 00:57,2019-08-12 03:57,2019-08-12 00:57:25.678259,700,-334,366,6.704762136274828,15,4,11
14,1,5,2019-08-15 00:57,2019-08-15 03:33,2019-08-15 00:57:25.678259,840,-521,319,6.709625416383305,13,3,10
15,1,5,2019-08-16 00:57,2019-08-16 03:21,2019-08-16 00:57:25.678259,770,-111,659,6.70905047752516,12,6,6
16,2,1,2019-08-12 09:23,2019-08-12 11:47,2019-08-12 09:23:25.700065,900,-443,457,6.048748328260203,12,3,9
17,2,1,2019-08-18 09:23,2019-08-18 12:23,2019-08-18 09:23:25.700065,930,-115,815,6.058796419747713,15,6,9
18,2,1,2019-08-15 09:23,2019-08-15 11:35,2019-08-15 09:23:25.700065,1100,-615,485,6.054925241270908,11,2,9
19,2,2,2019-08-12 02:27,2019-08-12 05:39,2019-08-12 02:27:25.725932,300,-120,180,8.428490338247085,16,5,11
20,2,2,2019-08-18 02:27,2019-08-18 05:15,2019-08-18 02:27:25.725932,300,0,300,8.428829499850666,14,7,7
21,2,2,2019-08-16 02:27,2019-08-16 06:15,2019-08-16 02:27:25.725932,290,-7,283,8.429035567646148,19,9,10
22,2,3,2019-08-12 06:07,2019-08-12 08:19,2019-08-12 06:07:25.750376,500,-239,261,6.181513776020455,11,2,9
23,2,3,2019-08-16 06:07,2019-08-16 08:43,2019-08-16 06:07:25.750376,520,-278,242,6.188843963061025,13,3,10
24,2,3,2019-08-18 06:07,2019-08-18 08:43,2019-08-18 06:07:25.750376,650,-358,292,6.188843963061025,13,3,10
25,2,4,2019-08-12 09:11,2019-08-12 11:35,2019-08-12 09:11:25.878459,700,-378,322,6.14768709795896,12,3,9
26,2,4,2019-08-17 09:11,2019-08-17 11:47,2019-08-17 09:11:25.878459,810,-327,483,6.155194077572029,13,4,9
27,2,4,2019-08-19 09:11,2019-08-19 11:35,2019-08-19 09:11:25.878459,770,-140,630,6.154306989534921,12,5,7
28,2,5,2019-08-12 01:42,2019-08-12 04:18,2019-08-12 01:42:25.901017,700,-628,72,6.199204479083128,13,1,12
29,2,5,2019-08-15 01:42,2019-08-15 04:06,2019-08-15 01:42:25.901017,780,-344,436,6.205587639393997,12,3,9
30,2,5,2019-08-17 01:42,2019-08-17 04:18,2019-08-17 01:42:25.901017,680,-274,406,6.206443044054255,13,4,9
31,2,6,2019-08-12 07:09,2019-08-12 09:21,2019-08-12 07:09:25.926419,200,-37,163,8.745939642369935,11,5,6
32,2,6,2019-08-15 07:09,2019-08-15 10:33,2019-08-15 07:09:25.926419,170,1,171,8.746030380249522,17,10,7
33,2,6,2019-08-17 07:09,2019-08-17 10:33,2019-08-17 07:09:25.926419,200,41,241,8.746030380249522,17,10,7
34,2,7,2019-08-12 05:15,2019-08-12 08:15,2019-08-12 05:15:25.951307,800,-338,462,6.5692928739779415,15,5,10
35,2,7,2019-08-19 05:15,2019-08-19 07:39,2019-08-19 05:15:25.951307,730,-419,311,6.574101888193685,12,2,10
36,2,7,2019-08-16 05:15,2019-08-16 07:51,2019-08-16 05:15:25.951307,680,-138,542,6.574746555629384,13,5,8
37,2,8,2019-08-12 03:52,2019-08-12 07:04,2019-08-12 03:52:25.975863,500,-199,301,6.234376678952947,16,5,11
38,2,8,2019-08-18 03:52,2019-08-18 06:40,2019-08-18 03:52:25.975863,520,-472,48,6.242302428105279,14,1,13
39,2,8,2019-08-18 03:52,2019-08-18 06:28,2019-08-18 03:52:25.975863,440,-440,0,6.241434790869614,13,0,13
40,2,9,2019-08-12 01:50,2019-08-12 04:26,2019-08-12 01:50:25.998012,500,-366,134,8.546948383969202,13,2,11
41,2,9,2019-08-17 01:50,2019-08-17 04:38,2019-08-17 01:50:25.998012,640,86,726,8.547161543038946,14,8,6
42,2,9,2019-08-16 01:50,2019-08-16 04:02,2019-08-16 01:50:25.998012,590,73,663,8.547094178290363,11,6,5
43,2,10,2019-08-12 06:18,2019-08-12 08:30,2019-08-12 06:18:26.017271,300,-4,296,8.713237305861908,11,5,6
44,2,10,2019-08-17 06:18,2019-08-17 08:54,2019-08-17 06:18:26.017271,350,40,390,8.713313347544371,13,8,5
45,2,10,2019-08-16 06:18,2019-08-16 08:54,2019-08-16 06:18:26.017271,340,87,427,8.713313347544371,13,8,5
46,3,1,2019-08-12 03:30,2019-08-12 06:42,2019-08-12 03:30:26.132077,300,-235,65,7.427366592044031,16,2,14
47,3,1,2019-08-19 03:30,2019-08-19 06:54,2019-08-19 03:30:26.132077,250,-64,186,7.43083732126053,17,7,10
48,3,1,2019-08-17 03:30,2019-08-17 06:18,2019-08-17 03:30:26.132077,280,-54,226,7.429932264796836,14,6,8
49,3,2,2019-08-12 01:51,2019-08-12 05:03,2019-08-12 01:51:26.157807,400,-172,228,6.570375647817699,16,5,11
50,3,2,2019-08-17 01:51,2019-08-17 04:51,2019-08-17 01:51:26.157807,510,-23,487,6.577189462879797,15,7,8
51,3,2,2019-08-16 01:51,2019-08-16 05:03,2019-08-16 01:51:26.157807,510,-390,120,6.577908389449814,16,3,13
52,3,3,2019-08-12 09:25,2019-08-12 12:37,2019-08-12 09:25:26.182794,700,-564,136,6.521369229134417,16,2,14
53,3,3,2019-08-18 09:25,2019-08-18 12:25,2019-08-18 09:25:26.182794,750,1,751,6.528460320902526,15,7,8
54,3,3,2019-08-19 09:25,2019-08-19 11:49,2019-08-19 09:25:26.182794,600,-205,395,6.526369565320942,12,4,8
55,3,4,2019-08-12 00:18,2019-08-12 02:54,2019-08-12 00:18:26.210944,700,-144,556,6.176579558123536,13,5,8
56,3,4,2019-08-19 00:18,2019-08-19 03:06,2019-08-19 00:18:26.210944,550,-363,187,6.1848395867659,14,3,11
57,3,4,2019-08-18 00:18,2019-08-18 02:54,2019-08-18 00:18:26.210944,630,-149,481,6.183935402586921,13,5,8
58,3,5,2019-08-12 06:34,2019-08-12 08:46,2019-08-12 06:34:26.235878,600,201,801,8.864834533492186,11,8,3
59,3,5,2019-08-17 06:34,2019-08-17 09:10,2019-08-17 06:34:26.235878,520,-167,353,8.864851429855669,13,4,9
60,3,5,2019-08-17 06:34,2019-08-17 08:58,2019-08-17 06:34:26.235878,760,39,799,8.86484942895102,12,6,6
61,3,6,2019-08-12 08:51,2019-08-12 11:51,2019-08-12 08:51:26.260373,500,-224,276,6.207775034879328,15,5,10
62,3,6,2019-08-18 08:51,2019-08-18 12:15,2019-08-18 08:51:26.260373,580,-367,213,6.218698860376926,17,4,13
63,3,6,2019-08-17 08:51,2019-08-17 11:03,2019-08-17 08:51:26.260373,540,-141,399,6.213304758941149,11,4,7
64,3,7,2019-08-12 05:17,2019-08-12 08:05,2019-08-12 05:17:26.283479,300,-135,165,7.404632228710429,14,4,10
65,3,7,2019-08-19 05:17,2019-08-19 08:05,2019-08-19 05:17:26.283479,340,-9,331,7.40727256056723,14,6,8
66,3,7,2019-08-19 05:17,2019-08-19 08:17,2019-08-19 05:17:26.283479,320,-164,156,7.407572716507232,15,4,11
67,3,8,2019-08-12 09:49,2019-08-12 12:37,2019-08-12 09:49:26.313521,600,-435,165,6.108028890137079,14,2,12
68,3,8,2019-08-16 09:49,2019-08-16 12:13,2019-08-16 09:49:26.313521,770,-549,221,6.114833947895444,12,2,10
69,3,8,2019-08-15 09:49,2019-08-15 12:49,2019-08-15 09:49:26.313521,670,-648,22,6.117677980413255,15,1,14
